101      0
102      0
103      0
104      0
105      0
106      0
107      0
108      0
109      0
110      0
201      0
202      0
203      0
204      0
205      0
206      0
207      0
208      0
209      0
210      0
301      0
302      0
303      0
304      0
305      0
306      0
307      0
308      0
309      0
310      0
401      0
402      0
403      0
404      0
405      0
406      0
407      0
408      0
409      0
410      0
501      0
502      0
503      0
504      0
505      0
506      0
507      0
508      0
509      0
510      0
601      0
602      0
603      0
604      0
605      0
606      0
607      0
608      0
609      0
610      0
701      0
702      0
703      0
704      0
705      0
706      0
707      0
708      0
709      0
710      0
801      0
802      0
803      0
804      0
805      0
806      0
807      0
808      0
809      0
810      0
901      0
902      0
903      0
904      0
905      0
906      0
907      0
908      0
909      0
1001     0
1002     0
1003     0
1004     0
1005     0
1006     0
1007     0
1008     0
1009     0
1010     0
0        0
